R 1920 1080
NO textures/canopy.xpm
SO textures/foliage.xpm
WE textures/autumn_leaves.xpm
EA textures/bamboo.xpm
S textures/sprite_goupix.xpm
F  50,   102,   50
C 0,0,139

11111111111111111111
10000000000000000001
10000000000000000001
10000010000000000001
100000000000S0000001
10000000000000000001
10000000000000000001
10000000000000000001
1000000000W000000001
10000000000000000001
10000000000000000001
11111111111111111111